%%%%%%%%%%%%%%%%%%%%%%%%%%%%%%%%%
%%%%%%%%%%%%%%%%%%%%%%%%%%%%%%%%%
%%%%%%%%%%%%%%%%%%           %%%%
%%%%%%%   %%%%%%%%%%%%%%%%%%%%%%%
%%%%%%%    %%%%%%%%%%%%%%%%%%%%%%
%%%%%%%     %%%%%%%%%%%%%%%%%%%%%
%%%%%%%%%%%%%%%%%%%%%%%%%%%%%%%%%
%%%%%%%%%%%%%%%%%%%%%%%%%%%%%%%%%
%%%%%%%%%%%%%%%%%  %%%%%%%%%%%%%%
%%%%               %%%%%%%%%%%%%%
%%%%                %%%%%%%%%%%%%
%%%%                %%%%%%%%%%%%%
%%%%                 %%%%%%%%%%%%
%%%%%%%%%%%%%%%%%%%%%%%%%%%%%%%%%
%%%%%%%%%%%%%%%%%%%%%%%%%%%%%%%%%
%%%%%%%%%%%%%%%%%%%%%%%%%%%%%%%%%
%%%%%%%%%%%%%%%%%%%%%%%%%%%%%%%%%
%%%%                  %%%%%%%%%%%
%%%%     %%%%%%%%%%%%%%%%%%%%%%%%
%%%%    %%%%%%%%%%%%%%%%%%%%%%%%%
%%%%   %%%%%%%%%%%%%%%%%%%%%%%%%%
%%%%  %%%%%%%%%%%%%%    %%%%%%%%%
%%%% %%%%%%%%%%%%%%%    %%%%%%%%%
%%%%%%%%%%%%%%%%%%%%    %%%%%%%%%
%%%%%%%%%%%%%%%%%%%%%%%%%%%%%%%%%
%%%%%%%%%%%%%%%%%%%%%%%%%%%%%%%%%
%%%%%%%%%%%%%%%%%%%%%%%%%%%%%%%%%
#
%%%%%%%%%%%%%%%%%%%%%%%%%%%%%%%%%
%%%%%%%%%%%%%%%%%%%%%%%%%%%%%%%%%
%%%%%%%%%%%%%%%%%%%%%%%%%%%%%%%%%
%%%%%P%%%%%%%%%%%%%%%%%%%%%%%% %%
%%%%%        %%%%%%%%%%%%%%%%%%%%
%%%%%%%%%%%%%%%%%%%%%%%%%%%%%%%%%
%%%%%%%%%%%%%%%%%%%%%%%%%%%%%%%%%
%%%%%%%%%%%%%%%%%%%%%%%%%  %%%%%%
%%%%%%%%%%%%%%%%%%%%%%%%%  %%%%%%
%%%%%%%%%%%%%%       %%%%%  %%%%%
%%%                  %%%%%  %%%%%
%%%                   %%%%% %%%%%
%%%  %%%%%%%%%%%%%%%%%%%%%%  %%%%
%%%  %%%%%%%%%%%%%%%%%%%%%%% %%%%
%%% %%%%%%%%%%%%%%%%%%%%%%%% %%%%
%%% %%%%%%%%%%%%%%%%%%%%%%%% %%%%
%%%  %%%%%%%%%%%%%%%%%%%%%%% %%%%
%%%   %%%%%%%%%%%%%%%%%%%%%%%%%%%
%%%        %%%%%%%%%%%%%%%%%%%%%%
%%%       %%%%%%%%%%%%%%%%%%%%%%%
%%%      %%%%%%%%%%%%%%%%%%%%%%%%
%%%     %%%%%%%%%%%%%%%%%%%%%% %%
%%%    %%%%%%.%%%%        %%%% %%
%%%   %%%%%%%%%%%%%%%%%%%%%%%% %%
%%%%%%%%%%%%%%%%%%%%%%%%%%%%%%%%%
%%%%%%%%%%%%%%%%%%%%%%%%%%%%%%%%%
%%%%%%%%%%%%%%%%%%%%%%%%%%%%%%%%%
#
%%%%%%%%%%%%%%%%%%%%%%%%%%%%%%%%%
%%%%%%%%%%%%%%%%%%%%%%%%%%%%%%%%%
%%%%%%%%%%%%%%%%%%%%%%%%%%%%%%%%%
%%%%%%%%%%%%%%%%%%%%%%%%%%%%%%%%%
%%%%%%%%%%%%%%%%%%%%%%%%%%%%%%% %
%%%%%%%%%%%%%%%%%%%%%%%%%%%%%%% %
%%%%%%%%%%%%%%%%%%%%%%%%%%%%%%% %
%%%%%%%%%%%%%%%%%%%%%%%%%%%%%%%%%
%%%%%%%%%%%%%%%%%%%%%%%%%  %%%%%%
%%%%%%%%%%%%%%%%%%%%%%%%%%  %%%%%
%%%%%%%%%%%%%%%%%%%%%%%%%%  %%%%%
%%   %%%%%%%%%%%%%%%%%%%%%% %%%%%
%%   %%%%%%%%%%%%%%%%%%%%%%  %%%%
%%   %%%%%%%%%%%%%%%%%%%%%%  %%%%
%%   %%%%%%%%%%%%%%%%%%%%%%  %%%%
%%   %%%%%%%%%%%%%%%%%%%%%%  %%%%
%%   %%%%%%%%%%%%%%%%%%%%%% %%%%%
%%   %%%%%%%%%%%%%%%%%%%%%%%%%%%%
%%   %%%%%%%%%%%%%%%%%%%%%%%%%%%%
%%      %%%%%%%%%%%%%%%%%%%%%%%%%
%%     %%%%%%%%%%%%%%%%%%%%%%%%%%
%%    %%%%%%%%%%%%%%%%%%%%%%%%% %
%%   %%%%%%%%%%%%%%%%%%%%%%%%%  %
%%%%%%%%%%%%%%%%%%%%%%%%%%%%%%%%%
%%%%%%%%%%%%%%%%%%%%%%%%%%%%%%%%%
%%%%%%%%%%%%%%%%%%%%%%%%%%%%%%%%%
%%%%%%%%%%%%%%%%%%%%%%%%%%%%%%%%%
#
