%%%%%%%%%%%%%%%%%%%%%%%%%%%%%%%%%%%%%%%%%%%%%%%%%%%%%%%%%%%%%%%
%%%%%%%%%%%%%%%%%%%%%%%%%%%%%%%%%%%%%%%%%%%%%%%%%%%%%%%%%%%%%%%
%%%%%%%%%%%%%%%%%%%%%%%%%%%%%                            %%%%%%
%%%%%%%%%%%%%%%%%%%%%%%%%%%%%%%%%%%%%%%%%%%%%%%%%%       %%%%%%
%%%%%%%%%%      %%%%%%%%%%%%%%%%%%%%%%%%%%%%%%%%%%       %%%%%%
%%%%%%%%%%        %%%%%%%%%%%%%%%%%%%%%%%%%%%%%%%%%      %%%%%%
%%%%%%%%%%                             %%%%%%%%%%%%      %%%%%%
%%%%%%%%%%                              %%%%%%%%%%%%     %%%%%%
%%%%%%%%%%                              %%%%%%%%%%%%     %%%%%%
%%%%%%%%%%                               %%%%%%%%%%%%    %%%%%%
%%%%%%%%%%         %%%%%%%%%%%%%%%%%%%%% %%%%%%%%%%%%    %%%%%%
%%%%%%%%%%       %%%%%%%%%%%%%%%%%%%%%%%% %%%%%%%%%%%%   %%%%%%
%%%%%%%%%%      %%%%%%%%%%%%%%%%%%%%%%%%% %%%%%%%%%%%%   %%%%%%
%%%%%%%%%%%%%%%%%%%%%%%%%%%%% %%%%%%%%%%%% %%%%%%%%%%%   %%%%%%
%%%%%%%%%%%%%%%%%%%%%%%%%%%%  %%%%%%%%%%%% %%%%%%%%%%%%  %%%%%%
%%%%%%%%%%%%%%%%%%%%%%%%%%     %%%%%%%%%%%%%%%%%%%%%%%%  %%%%%%
%%%%%%                         %%%%%%%%%%%% %%%%%%%%%%%% %%%%%%
%%%%%%                          %%%%%%%%%%%%%%%%%%%%%%%% %%%%%%
%%%%%%                          %%%%%%%%%%%% %%%%%%%%%%%%%%%%%%
%%%%%%                           %%%%%%%%%%%%%%%%%%%%%%%%%%%%%%
%%%%%%                           %%%%%%%%%%%% %%%%%%%%%%%%%%%%%
%%%%%%%%%%%%%%%%%%%%%%%%%%%%%%%%%%%%%%%%%%%%%%%%%%%%%%%%%%%%%%%
%%%%%%%%%%%%%%%%%%%%%%%%%%%%%%%%%%%%%%%%%%%%%% %%%%%%%%%%%%%%%%
%%%%%%%%%%%%%%%%%%%%%%%%%%%%%%%%%%%%%%%%%%%%%% %%%%%%%%%%%%%%%%
%%%%%%%%%%%%%%%%%%%%%%%%%%%%%%%%%%%%%%%%%%%%%% %%%%%%%%%%%%%%%%
%%%%%%%%%%%%%%%%%%%%%%%%%%%%%%%%%%%%%%%%%%%%%% %%%%%%%%%%%%%%%%
%%%%%%                             %%%%%%%%%%%%%%%%%%%%%%%%%%%%
%%%%%%                             %%%%%%%%%%%%%%%%%%%%%%%%%%%%
%%%%%%                             %%%%%%%%%%%%%%%%%%%%%%%%%%%%
%%%%%%         %%%%%%%%%%%%%%%%%%%%%%%%%%%%%%%%%%%%%%%%% %%%%%%
%%%%%%        %%%%%%%%%%%%%%%%%%%%%%%%%%%%%%%%%%%%%%%%%% %%%%%%
%%%%%%       %%%%%%%%%%%%%%%%%%%%%%%%%%%%%%%%%%%%%%%%%%  %%%%%%
%%%%%%      %%%%%%%%%%%%%%                %%%%%%%%%%%%   %%%%%%
%%%%%%     %%%%%%%%%%%%%%%                %%%%%%%%%%%    %%%%%%
%%%%%%    %%%%%%%%%%%%%%%%                %%%%%%%%%%%    %%%%%%
%%%%%%   %%%%%%%%%%%%%%%%%                %%%%%%%%%%%    %%%%%%
%%%%%%  %%%%%%%%%%%%%%%%%%                %%%%%%%%%%%    %%%%%%
%%%%%% %%%%%%%%%%%%%%%%%%%                %%%%%%%%%%%    %%%%%%
%%%%%%%%%%%%%%%%%%%%%%%%%%                %%%%%%%%%%%    %%%%%%
%%%%%%%%%%%%%%%%%%%%%%%%%%%%%%%%%%%%%%%%%%%%%%%%%%%%%    %%%%%%
%%%%%%%%%%%%%%%%%%%%%%%%%%%%%%%%%%%%%%%%%%%%%%%%%%%%%    %%%%%%
%%%%%%%%%%%%%%%%%%%%%%%%%%%%%%%%%%%%%%%%%%%%%%%%%%%%%    %%%%%%
%%%%%%                             %%%%%%%%%%%%%%%%%%    %%%%%%
%%%%%%                             %%%%%%%%%%%%%%%%%%%%%%%%%%%%
%%%%%%                             %%%%%%%%%%%%%%%%%%%%%%%%%%%%
%%%%%%                             %%%%%%%%%%%%%%%%%%%%%%%%%%%%
%%%%%%                             %%%%%%%%%%%         %%%%%%%%
%%%%%%                             %%%%%%%%%%%         %%%%%%%%
%%%%%%                             %%%%%%%%%%%.........%%%%%%%%
%%%%%%                             %%%%%%%%%%%.........%%%%%%%%
%%%%%%                             %%%%%%%%%%%.........%%%%%%%%
%%%%%%                             %%%%%%%%%%%.........%%%%%%%%
%%%%%%                             %%%%%%%%%%%.........%%%%%%%%
%%%%%%                             %%%%%%%%%%%         %%%%%%%%
%%%%%%                             %%%%%%%%%%%         %%%%%%%%
%%%%%%                             %%%%%%%%%%%%%%%%%%%%%%%%%%%%
%%%%%%                             %%%%%%%%%%%%%%%%%%%%%%%%%%%%
%%%%%%                             %%%%%%%%%%%%%%%%%%%%%%%%%%%%
%%%%%%                                                   %%%%%%
%%%%%%%%%%%%%%%%%%%%%%%%%%%%%%%%%%%%%%%%%%%%%%%%%%%%%%%%%%%%%%%
%%%%%%%%%%%%%%%%%%%%%%%%%%%%%%%%%%%%%%%%%%%%%%%%%%%%%%%%%%%%%%%
#
%%%%%%%%%%%%%%%%%%%%%%%%%%%%%%%%%%%%%%%%%%%%%%%%%%%%%%%%%%%%%%%
%%%%%%%%%%%%%%%%%%%%%%%%%%%%%%%%%%%%%%%%%%%%%%%%%%%%%%%%%%%%%%%
%%%%%%%%%%%%%%%%%%%%%%%%%%%%%%%%%%%%%%%%%%%%%%%%%%%%%%%%%%%%%%%
%%%%%%%%%%%%%%%%%%%%%%%%%%%%%%%%%%%%%%%%%%%%%%%%%%%%%%%%%%%%%%%
%%%%%%%%%%%%%%%%%%%%%%%%%%%%%%%%%%%%%%%%%%%%%%%%           %%%%
%%%%%%%%%%%%%%%%%%%%%%%%%%%%%%%%%%%%%%%%%%%%%%%%           %%%%
%%%%%%%%             %%%%%%%%%%%%%%%%%%%%%%%%%%%%          %%%%
%%%%%%%%               %%%%%%%%%%%%%%%%%%%%%%%%%%          %%%%
%%%%%%%%P              %%%%%%%%%%%%%       %%%%%%%         %%%%
%%%%%%%%              %%%%%%%%%%%%%%%      %%%%%%%         %%%%
%%%%%%%%            %%%%%%%%%%%%%%%%%%      %%%%%%%        %%%%
%%%%%%%%%%%%%%%%%%%%%%%%%%%%%%%%%%%%%%      %%%%%%%        %%%%
%%%%%%%%%%%%%%%%%%%%%%%%%%%%%%%%%%%%%%%      %%%%%%%       %%%%
%%%%%%%%%%%%%%%%%%%%%%%%%%%%%%%%%%%%%%%      %%%%%%%       %%%%
%%%%%%%%%%%%%%%%%%%%%%%%%%%%%%%%%%%%%%%%     %%%%%%%       %%%%
%%%%%%%%%%%%%%%%%%%%%%%%%        %%%%%%%      %%%%%%%      %%%%
%%%%%%%%%%%%%%%%%%%%%%%           %%%%%%%     %%%%%%%      %%%%
%%%%%%%%%%%%%%%%%%%%%%            %%%%%%%      %%%%%%%     %%%%
%%%%                               %%%%%%%     %%%%%%%     %%%%
%%%%     %%%%%%%%%%%%%%%%%%%%%%%%%%%%%%%%%%     %%%%%%%    %%%%
%%%%    %%%%%%%%%%%%%%%%%%%%%%%%%%%%%%%%%%%     %%%%%%%    %%%%
%%%%   %%%%%%%%%%%%%%%%%%%%%%%%%%%%%%%%%%%%%     %%%%%%%   %%%%
%%%%   %%%%%%%%%%%%%%%%%%%%%%%%%%%%%%%%%%%%%     %%%%%%%   %%%%
%%%%   %%%%%%%%%%%%%%%%%%%%%%%%%%%%%%%%%%%%%     %%%%%%%   %%%%
%%%%   %%%%%%%%%%%%%%%%%%%%%%%%%%%%%%%%%%%%%     %%%%%%%   %%%%
%%%%   %%%%%%%%%%%%%%%%%%%%%%%%%%%%%%%%%%%%%     %%%%%%%   %%%%
%%%%    %%%%%%%%%%%%%%%%%%%%%%%%%%%%%%%%%%%%    %%%%%%%%   %%%%
%%%%     %%%%%%%%%%%%%%%%%%%%%%%%%%%%%%%%%%%   %%%%%%%%%   %%%%
%%%%              %%%%%%%%%%%%%%%%%%%%%%%%%%   %%%%%%%%    %%%%
%%%%             %%%%%%%%%%%%%%%%%%%%%%%%%%%  %%%%%%%%     %%%%
%%%%            %%%%%%%%%%%%%%%%%%%%%%%%%%%% %%%%%%%%      %%%%
%%%%           %%%%%%%%%%%%%%%%%%%%%%%%%%%%%%%%%%%%%%      %%%%
%%%%          %%%%%%%%%%%%%%%%%%%%%%%%%%%%% %%%%%%%%       %%%%
%%%%         %%%%%%%%%%%%%%%%%%%%%%%%%%%%%  %%%%%%%        %%%%
%%%%        %%%%%%%%%%%%                    %%%%%%%        %%%%
%%%%       %%%%%%%%%%%%%                    %%%%%%%        %%%%
%%%%      %%%%%%%%%%%%%%                    %%%%%%%        %%%%
%%%%     %%%%%%%%%%%%%%%%%%%%%%%%%%%%%%%%%  %%%%%%%        %%%%
%%%%    %%%%%%%%%%%%%%%%%%%%%%%%%%%%%%%%%%% %%%%%%%        %%%%
%%%%   %%%%%%%%%%%%%%%%%%%%%%%%%%%%%%%%%%%%%%%%%%%%        %%%%
%%%%   %%%%%%%%%%%%%%%%%%%%%%%%%%%%%%%%%%%%%%%%%%%%        %%%%
%%%%   %%%%%%%%%%%%%%%%%%%%%%%%%%%%%%%%%%%%%%%%%%%%%%%%%%%%%%%%
%%%%    %%%%%%%%%%%%%%%%%%%%%%%%%%%%%%%%%%%%%%%%%%%%%%%%%%%%%%%
%%%%     %%%%%%%%%%%%%%%%%%%%%%%%%%%%%%%%%%%%%%%%%%%%%%%%%%%%%%
%%%%                                 %%%%%%%%%%%%%%%%%%%%%%%%%%
%%%%                                 %%%%%%%%%%%%%%%%%%%%%%%%%%
%%%%                                 %%%%%%% %%%%%%%%%%%%%%%%%%
%%%%                                 %%%%%%%  %%%%%%%%%%%%%%%%%
%%%%                                 %%%%%%%    .....    %%%%%%
%%%%                                 %%%%%%%   .......   %%%%%%
%%%%                                 %%%%%%%   .......   %%%%%%
%%%%                                 %%%%%%%   .......   %%%%%%
%%%%                                 %%%%%%%    .....    %%%%%%
%%%%                                 %%%%%%%%%%%%%%%%%%%%%%%%%%
%%%%                                 %%%%%%%%%%%%%%%%%%%%%%%%%%
%%%%                                 %%%%%%%%%%%%%%%%%%%%%%%%%%
%%%%                                 %%%%%%%%%%%%%%%%%%%%%%%%%%
%%%%%%%%%%%%%%%%%%%%%%%%%%%%%%%%%%%%%%%%%%%%%%%%%%%%%%%%%%%%%%%
%%%%%%%%%%%%%%%%%%%%%%%%%%%%%%%%%%%%%%%%%%%%%%%%%%%%%%%%%%%%%%%
%%%%%%%%%%%%%%%%%%%%%%%%%%%%%%%%%%%%%%%%%%%%%%%%%%%%%%%%%%%%%%%
%%%%%%%%%%%%%%%%%%%%%%%%%%%%%%%%%%%%%%%%%%%%%%%%%%%%%%%%%%%%%%%
#
%%%%%%%%%%%%%%%%%%%%%%%%%%%%%%%%%%%%%%%%%%%%%%%%%%%%%%%%%%%%%%%
%%%%%%%%%%%%%%%%%%%%%%%%%%%%%%%%%%%%%%%%%%%%%%%%%%%%%%%%%%%%%%%
%%%%%%%%%%%%%%%%%%%%%%%%%%%%%%%%%%%%%%%%%%%%%%%%%%%%%%%%%%%%%%%
%%%%%%%%%%%%%%%%%%%%%%%%%%%%%%%%%%%%%%%%%%%%%%%%%%%%%%%%%%%%%%%
%%%%%%%%%%%%%%%%%%%%%%%%%%%%%%%%%%%%%%%%%%%%%%%%%%%%%%%%%%%%%%%
%%%%%%%%%%%%%%%%%%%%%%%%%%%%%%%%%%%%%%%%%%%%%%%%%%%%%%%%%%%%%%%
%% %%%%%%%%%%%%%%%%%%%%%%%%%%%%%%%%%%%%%%%%%%%%%%            %%
%% %%%%%%%%%%%%%%%%%%%%%%%%%%%%%%%%%%%%%%%%%%%%%%%           %%
%% %%%              %%%%%%%%%%%%%%%%%%%%%%%%%%%%%%           %%
%% %%%%%%%%%%%%%%%%%%%%%%%%%%%%%%%%%%%%%%%%%%%%%%%           %%
%% %%%%%%%%%%%%%%%%%%%%%%%%%%%%%%%%%%%     %%%%%%%%          %%
%% %%%%%%%%%%%%%%%%%%%%%%%%%%%%%%%%%%%%     %%%%%%%          %%
%% %%%%%%%%%%%%%%%%%%%%%%%%%%%%%%%%%%%%     %%%%%%%%         %%
%% %%%%%%%%%%%%%%%%%%%%%%%%%%%%%%%%%%%%%     %%%%%%%         %%
%% %%%%%%%%%%%%%%%%%%%%%%%%%%%%%%%%%%%%%     %%%%%%%%        %%
%% %%%%%%%%%%%%%%%%%%%%%%%%%%%%%%%%%%%%%%     %%%%%%%        %%
%% %%%%%%%%%%%%%%%%%%%%%%%%%%%%%%%%%%%%%%     %%%%%%%%       %%
%% %%%%%%%%%%%%%%%%%%%%%%%%%%%%%%%%%%%%%%%     %%%%%%%       %%
%% %%%%%%%%%%%%%%%%%%%%%%%%%%%%%%%%%%%%%%%     %%%%%%%       %%
%% %%%%%%%%%%%%%%%%%%%%%%%%%%%%%%%%%%%%%%%     %%%%%%%       %%
%%       %%%%%%%%%%%%%%%%%%%%%%%%%%%%%%%%%      %%%%%%       %%
%%       %%%%%%%%%%%%%%%%%%%%%%%%%%%%%%%%%      %%%%%%       %%
%%       %%%%%%%%%%%%%%%%%%%%%%%%%%%%%%%%%       %%%%%       %%
%%       %%%%%%%%%%%%%%%%%%%%%%%%%%%%%%%%%       %%%%%       %%
%%       %%%%%%%%%%%%%%%%%%%%%%%%%%%%%%%%%      %%%%%%       %%
%%       %%%%%%%%%%%%%%%%%%%%%%%%%%%%%%%%%      %%%%%%       %%
%%       %%%%%%%%%%%%%%%%%%%%%%%%%%%%%%%%%     %%%%%%%       %%
%%       %%%%%%%%%%%%%%%%%%%%%%%%%%%%%%%%%    %%%%%%%%       %%
%%       %%%%%%%%%%%%%%%%%%%%%%%%%%%%%%%%%    %%%%%%%%       %%
%%       %%%%%%%%%%%%%%%%%%%%%%%%%%%%%%%%%    %%%%%%%%       %%
%%            %%%%%%%%%%%%%%%%%%%%%%%%%%%%    %%%%%%%%       %%
%%           %%%%%%%%%%%%%%%%%%%%%%%%%%%%%    %%%%%%%%       %%
%%          %%%%%%%%%%%%%%%%%%%%%%%%%%%%%%    %%%%%%%        %%
%%         %%%%%%%%%%%%%%%%%%%%%%%%%%%%%%%    %%%%%%         %%
%%        %%%%%%%%%%%%%%%%%%%%%%%%%%%%%%%%    %%%%%%         %%
%%       %%%%%%%%%%%%%%%%%%%%%%%%%%%%%%%%%    %%%%%          %%
%%       %%%%%%%%%%%%%%%%%%%%%%%%%%%%%%%%%    %%%%           %%
%%       %%%%%%%%%%%%%%%%%%%%%%%%%%%%%%%%%    %%%            %%
%%       %%%%%%%%%%%%%%%%%%%%%%%%%%%%%%%%%    %%%            %%
%%       %%%%%%%%%%%%%%%%%%%%%%%%%%%%%%%%%    %%%%%%%%%%%%%%%%%
%%       %%%%%%%%%%%%%%%%%%%%%%%%%%%%%%%%%    %%%%%%%%%%%%%%%%%
%%       %%%%%%%%%%%%%%%%%%%%%%%%%%%%%%%%%    %%%%%%%%%%%%%%%%%
%%       %%%%%%%%%%%%%%%%%%%%%%%%%%%%%%%%%    %%%%%%%%%%%%%%%%%
%%       %%%%%%%%%%%%%%%%%%%%%%%%%%%%%%%%%    %%%%%%%%%%%%%%%%%
%%       %%%%%%%%%%%%%%%%%%%%%%%%%%%%%%%%%    %%%%%%%%%%%%%%%%%
%%       %%%%%%%%%%%%%%%%%%%%%%%%%%%%%%%%%    %%%%%%%%%%%%%%%%%
%%                                     %%%    %%%%%%%%%%%%%%%%%
%%                                     %%%    %%%%%%%%%%%%%%%%%
%%                                     %%%    %%%%%%%%%%%%%%%%%
%%                                     %%%    %%%%%%%%%%%%%%%%%
%%                                     %%%      .....      %%%%
%%                                     %%%%%%%%%%%%%%%%%%%%%%%%
%%                                     %%%%%%%%%%%%%%%%%%%%%%%%
%%                                     %%%%%%%%%%%%%%%%%%%%%%%%
%%                                     %%%%%%%%%%%%%%%%%%%%%%%%
%%%%%%%%%%%%%%%%%%%%%%%%%%%%%%%%%%%%%%%%%%%%%%%%%%%%%%%%%%%%%%%
%%%%%%%%%%%%%%%%%%%%%%%%%%%%%%%%%%%%%%%%%%%%%%%%%%%%%%%%%%%%%%%
%%%%%%%%%%%%%%%%%%%%%%%%%%%%%%%%%%%%%%%%%%%%%%%%%%%%%%%%%%%%%%%
%%%%%%%%%%%%%%%%%%%%%%%%%%%%%%%%%%%%%%%%%%%%%%%%%%%%%%%%%%%%%%%
%%%%%%%%%%%%%%%%%%%%%%%%%%%%%%%%%%%%%%%%%%%%%%%%%%%%%%%%%%%%%%%
%%%%%%%%%%%%%%%%%%%%%%%%%%%%%%%%%%%%%%%%%%%%%%%%%%%%%%%%%%%%%%%
#
