%%%%%%%%%%%%%%%%%%%%%%%%%%%%%%%%%%%%%%%
%%%%%%%%%%%%%%%%%%%%%%%%%%%%%%%%%%%%%%%
%%%%%%%%%%%%%%%%%%%%%%%%%%%%%%%%   %%%%
%%%%%%%    %%%%%%%%%%%%%%%%%%%%%   %%%%
%%%%%%%                  %%%%%%%%  %%%%
%%%%%%%                  %%%%%%%%  %%%%
%%%%%%%     %%%%%%%%%%%%% %%%%%%%% %%%%
%%%%%%%    %%%%%%%%%%%%%%%%%%%%%%% %%%%
%%%%%%%%%%%%%%%%%%%%%%%%%%%%%%%%%% %%%%
%%%%%%%%%%%%%%%%%  %%%%%%%%%%%%%%%%%%%%
%%%%%%%%%%%%%%%%   %%%%%%%%%%%%%%%%%%%%
%%%%                %%%%%%%%%%%%%%%%%%%
%%%%                %%%%%%%%%%%%%%%%%%%
%%%%%%%%%%%%%%%%%%%%%%%%%%%%%%%%%%%%%%%
%%%%%%%%%%%%%%%%%%%%%%%%%%%%%%%%%%%%%%%
%%%%%%%%%%%%%%%%%%%%%%%%%%%%%%%%%%%%%%%
%%%%%%%%%%%%%%%%%%%%%%%%%%%%%%%%%%%%%%%
%%%%                  %%%%%%%%%%%%%%%%%
%%%%     %%%%%%%%%%%%%%%%%%%%%%%%%%%%%%
%%%%    %%%%%%%%%%%%%%%%%%%%%%%%%%%%%%%
%%%%   %%%%%%%%%%%%%%%%%%%%%%%%%%% %%%%
%%%%  %%%%%%%%%%%         %%%%%%%% %%%%
%%%% %%%%%%%%%%%%         %%%%%%%% %%%%
%%%%%%%%%%%%%%%%%         %%%%%%%% %%%%
%%%%%%%%%%%%%%%%%%%%%%%%%%%%%%%%%% %%%%
%%%%%%%%%%%%%%%%%%%%%%%%%%%%%%%%%% %%%%
%%%%%%%%%%%%%%%%%%%%%%%%%%%%%%%%%% %%%%
%%%%                  %%%%%%%%%%%%%%%%%
%%%%                  %%%%%%%%%%%%%%%%%
%%%%                  %%%%%%%     %%%%%
%%%%                  %%%%%%%.....%%%%%
%%%%                  %%%%%%%.....%%%%%
%%%%                  %%%%%%%.....%%%%%
%%%%                  %%%%%%%     %%%%%
%%%%                  %%%%%%%%%%%%%%%%%
%%%%                  %%%%%%%%%%%%%%%%%
%%%%                  %%%%%%%%%%%%%%%%%
%%%%%%%%%%%%%%%%%%%%%%%%%%%%%%%%%%%%%%%
#
%%%%%%%%%%%%%%%%%%%%%%%%%%%%%%%%%%%%%%%
%%%%%%%%%%%%%%%%%%%%%%%%%%%%%%%%%%%%%%%
%%%%%%%%%%%%%%%%%%%%%%%%%%%%%%%%%%%%%%%
%%%%%%%%%%%%%%%%%%%%%%%%%%%%%%%      %%
%%%%%        %%%%%%%%%%%%%%%%%%      %%
%%%%%P        %%%%%%%%%    %%%%%     %%
%%%%%        %%%%%%%%%%%   %%%%%     %%
%%%%%%%%%%%%%%%%%%%%%%%%    %%%%     %%
%%%%%%%%%%%%%%%%%%%%%%%%%   %%%%%    %%
%%%%%%%%%%%%%%%%%%%%%%%%%   %%%%%    %%
%%%%%%%%%%%%%%%      %%%%%   %%%%%   %%
%%%%%%%%%%%%%        %%%%%%  %%%%%   %%
%%%  %%%%%%%%%%%%%%%%%%%%%%   %%%%%  %%
%%%  %%%%%%%%%%%%%%%%%%%%%%%  %%%%%  %%
%%% %%%%%%%%%%%%%%%%%%%%%%%%   %%%%  %%
%%% %%%%%%%%%%%%%%%%%%%%%%%%   %%%%  %%
%%%  %%%%%%%%%%%%%%%%%%%%%%%  %%%%%  %%
%%%   %%%%%%%%%%%%%%%%%%%%%% %%%%%%  %%
%%%        %%%%%%%%%%%%%%%%% %%%%%   %%
%%%       %%%%%%%%%%%%%%%%%%%%%%%%   %%
%%%      %%%%%%%%%%%%%%%%%% %%%%%    %%
%%%     %%%%%%%%%%%%%%%%%%  %%%%     %%
%%%    %%%%%%%%             %%%%     %%
%%%   %%%%%%%%%%%%%%%%%%%%% %%%%     %%
%%%  %%%%%%%%%%%%%%%%%%%%%%%%%%%     %%
%%% %%%%%%%%%%%%%%%%%%%%%%%%%%%%     %%
%%%  %%%%%%%%%%%%%%%%%%%%%%%%%%%%%%%%%%
%%%   %%%%%%%%%%%%%%%%%%%%%%%%%%%%%%%%%
%%%                    %%%%%%%%%%%%%%%%
%%%                    %%%%%%%%%%%%%%%%
%%%                    %%%%%  ....  %%%
%%%                    %%%%%  ....  %%%
%%%                    %%%%%  ....  %%%
%%%                    %%%%%%%%%%%%%%%%
%%%                    %%%%%%%%%%%%%%%%
%%%                    %%%%%%%%%%%%%%%%
%%%%%%%%%%%%%%%%%%%%%%%%%%%%%%%%%%%%%%%
%%%%%%%%%%%%%%%%%%%%%%%%%%%%%%%%%%%%%%%
#
%%%%%%%%%%%%%%%%%%%%%%%%%%%%%%%%%%%%%%%
%%%%%%%%%%%%%%%%%%%%%%%%%%%%%%%%%%%%%%%
%%%%%%%%%%%%%%%%%%%%%%%%%%%%%%%%%%%%%%%
%%%%%%%%%%%%%%%%%%%%%%%%%%%%%%%%%%%%%%%
%%%%%%%%%%%%%%%%%%%%%%%%%%%%%%%       %
%%%%%%%%%%%%%%%%%%%%%%%%%%%%%%%%      %
%%%%%%%%%%%%%%%%%%%%%%%%%%%%%%%%      %
%%%%%%%%%%%%%%%%%%%%%%%%%  %%%%%%     %
%%%%%%%%%%%%%%%%%%%%%%%%%   %%%%%     %
%%%%%%%%%%%%%%%%%%%%%%%%%%  %%%%%%    %
%%%%%%%%%%%%%%%%%%%%%%%%%%   %%%%%    %
%%%%%%%%%%%%%%%%%%%%%%%%%%%  %%%%%    %
%%%%%%%%%%%%%%%%%%%%%%%%%%%   %%%%    %
%%   %%%%%%%%%%%%%%%%%%%%%%   %%%%    %
%%   %%%%%%%%%%%%%%%%%%%%%%   %%%%    %
%%   %%%%%%%%%%%%%%%%%%%%%%   %%%%    %
%%   %%%%%%%%%%%%%%%%%%%%%%  %%%%%    %
%%   %%%%%%%%%%%%%%%%%%%%%%  %%%%%    %
%%   %%%%%%%%%%%%%%%%%%%%%% %%%%%%    %
%%      %%%%%%%%%%%%%%%%%%% %%%%%%    %
%%     %%%%%%%%%%%%%%%%%%%% %%%%%%    %
%%    %%%%%%%%%%%%%%%%%%%%% %%%%%     %
%%   %%%%%%%%%%%%%%%%%%%%%% %%%%      %
%%   %%%%%%%%%%%%%%%%%%%%%% %%%       %
%%   %%%%%%%%%%%%%%%%%%%%%% %%%%%%%%%%%
%%   %%%%%%%%%%%%%%%%%%%%%% %%%%%%%%%%%
%%   %%%%%%%%%%%%%%%%%%%%%% %%%%%%%%%%%
%%   %%%%%%%%%%%%%%%%%%%%%% %%%%%%%%%%%
%%   %%%%%%%%%%%%%%%%%%%%%% %%%%%%%%%%%
%%                      %%% %%%%%%%%%%%
%%                      %%% %%%%%%%%%%%
%%                      %%%  %%%%%%%%%%
%%                      %%%%%%%%%%%%%%%
%%                      %%%%%%%%%%%%%%%
%%%%%%%%%%%%%%%%%%%%%%%%%%%%%%%%%%%%%%%
%%%%%%%%%%%%%%%%%%%%%%%%%%%%%%%%%%%%%%%
%%%%%%%%%%%%%%%%%%%%%%%%%%%%%%%%%%%%%%%
%%%%%%%%%%%%%%%%%%%%%%%%%%%%%%%%%%%%%%%
#
