%%%%%%%%%%%%%%%%%%%%
%P         %%      %
% %% %% %% %%%%%%% %
% %% %.          %.%
%%%%%%%%%%%%%%%%%%%%
#
%%%%%%%%%%%%%%%%%%%%
%          %%%%%%%%%
%%%% %%%%% %% %% %%%
%  . %%%         %%%
%%%%%%%%%%%%%%%%%%%%
#
%%%%%%%%%%%%%%%%%%%%
%          %%%%%%%%%
%    %%%%  % .%% %%%
%  . %%%   %%%%%%%%%
%%%%%%%%%%%%%%%%%%%%
#