%%%%%%%%%%%%%%%%%%%%%%%
%         %.%         %
%         % %         %
%%%%%%%%%%% %%%%%%%%%%%
%.         P         .%
%%%%%%%%%%% %%%%%%%%%%%
%         % %         %
%         %.%         %
%%%%%%%%%%%%%%%%%%%%%%%