%%%%%%%%%%%%%%%%%%%%%%%
%                     %
%                     %
%%%%%%%%%%%%%%%%%%%%%%%
%.      P            .%
%%%%%%%%%%%%%%%%%%%%%%%
%                     %
%                     %
%%%%%%%%%%%%%%%%%%%%%%%