%%%%%%%%%%%%%%%%%%%%%%%%%%%%%%%%%
%   P .   .   .   .   .   .     %
%                               %
%                               %
%                               %
%   .                           %
%%%%%%%%%%%%%%%%%%%%%%%%%%%%%%%%%